1111111111111111111111
100000000B1000100000C1
100C00000B10C010000001
1P0000000B100010C000B1
100000000B1100100000B1
10000000000000100000B1
100000000B1110100000B1
100000C00B100010000001
100000000B100011001011
100000000B100C000000E1
1111111111111111111111
