1111111111111111111111
1000000000000000000001
1000000000000000000001
1000000000000000000001
10000BBBBBBBB000000001
10P00CCCCCCCC00E000001
10000BBBBBBBBB00000001
1000000000000000000001
1000000000000000000001
1000000000000000000001
1111111111111111111111
