1111111111111111111111
1000000000C000000000C1
100C000000000000111001
1P0010C0B0011111000001
1000100000010000000001
1000100000010000C00001
100000CB00000001000001
10BB100000010000BBBB01
1000111111111111111111
10000000C00000000000E1
1111111111111111111111
