1111111111111111111111
1111P10000000000000111
1111000000000000001111
1000C0000000000000C001
1000000000000000000001
1C00000000000000000001
1000000000000000000001
100000000000000000E001
1000000000000000000001
1000000000000000000001
1111111111111111111111

