1111111111111111111111
1000000001000000000001
100P0000000000000E0001
1000000C01000000000001
1111111111000000000001
10BBBBBBBB000000000001
1000000000000000000001
100111111111C000000001
100B000B00000000C00001
10000B000B000000000001
1111111111111111111111
