1111111111111111111111
1000000000C000000000C1
100C010000000000111001
1P00110000000000000001
1000000000000000000001
1000000000E00000000001
10B0000000000000000001
1000000000000000000001
10000B0000000000000001
1000000000000000000001
1111111111111111111111
