1111111111111111111111
1000000000C000000000C1
100C000000000000111001
1P0010C000011111000001
1000100000010000000001
1000100000010000C00001
1011100C00010000000001
10BB100000010000BBBB01
1000111110010001111111
10BB1000C00100000000E1
1111111111111111111111
