11111111111111111111111111111111
10000000000000000000000000000001
10000000000000000000000000000001
100P0000000000000000000000000001
10000000000000000000000000000001
10000C00000000000000000000000001
10000000000000000000000000000001
100000000E0000000000000000000001
10000000000000000000000000000001
10000000000000000000000000000001
11111111111111111111111111111111
