11111111111111111111111111111111
10000000000000000000000000000001
10000000000000000000000000000001
10000000000000CCC000000000000001
10000000000000CPC000000000000001
10000000000000CCC000000000000001
10000000000000000000000000000001
10000000000000000000000000000001
10000000000000000E00000000000001
10000000000000000000000000000001
11111111111111111111111111111111
